.........................................................................
.........................................................................
...........................:=*%@@@@#.@@@@@%*=:...........................
......................:+%@@%*=-...........-=*%@@%+:......................
...................=%@@*-......-=+*****+=-......-*@@%=...................
................:%@@=....-#@@@@%*+=---=+*%@@@@#-....=@@#:................
..............-@@*...:#@@@=:.................:=@@@*....*@@-..............
............:@@+...*@@#.....+@@@@@@@@@@@@@@@+....:%@@+...*@@.............
...........#@#...#@@-.......::.............:#@@@+...-@@*...#@#...........
.........:@@:..+@%...-@@%.....:-+%@@@@@%+-...+@=%@@-..:@@=..:@@:.........
........-@#..:@@-..=@@+.@#....@%+-:...:=*#@@@@-...+@@=..=@%:..%@-........
.......=@*..=@#..:@@=...#@:...=@..:---:.....:*@@+...+@@:..%@-..#@=.......
......=@#..+@*..+@%...*@%-...+#@@@@%%%@@@@#=...-%@+...%@+..#@=..%@=......
......@%..=@*..*@*..-@@-..-%@@=...........=@@%:..-@@:..*@+..%@-..%@......
.....%@:.:@%..+@+..+@#..:@@+...*%@@@%@#......*@%...#@-..+@+..%@..-@%.....
....-@*..%@..-@%..-@*..=@%..-@*..#+...*#......@@@-..#@-..%@:.:@%..*@-....
....#@:.:@*..#@...******=..#%....:@=.+@......@*.#@:..@@...@#..#@..:@*....
....@@..#@-.:@*.............*@-...........-%%:...#%..:%=..*@:.=@+..@@....
...-@#..@@..*@=...............:*#@.....@%*-...............=@+.:@%..#@:...
...-@+..@%..%@:.:@@@@@@@@@@@@...:@.....@:..++=-...........-@#..@@..*@-...
...-@+..@%..#@:.:@%........*@...:@.....@:..%@=+*%@@*..**..-@#..@@..*@-...
...-@#..@@..*@=..@%..-#####@*...:@.....@:..%@-...=@=..@%..=@+.:@%..#@:...
....@@..#@-.:@*..*@:.:@%........-@%%%%%@-...:+@..@@..:@*..#@..=@+..@@....
....#@-.:@*..#@..:@%..-@*...=@@#:.......-%@@-...#@:..@@...@#..#@..-@*....
....:@*..%@..-@%..-@*..=@@@@:...............=@@@@-..#@-..%@:.:@%..*@-....
.....%@:.:@%..=@+..+@#..:@@+.................*@%...#@-...:-..%@..-@%.....
......@%..=@*..*@*..-@@-..-%@@-...........=@@%:..-@@:.......%@-..%@......
......=@%..+@*..=@%...*@%-...+%@.  :#%@@@@#=...-%@+...-....#@=..%@-......
.......=@#..=@#..:%@+...*@@*..=@...-@=:.....:*@@+...+@%:..%@-..#@=.......
........-@%..:@@-..-@%...-@+..=@...-@-..+#@@@*:...*@@-..=@%:..%@-........
.........:@@:..+@%......=@*...@#...%@#..-@#....-%@@-..:@@=..:@@:.........
...........#@#...#@@:..-@%...@@...*@+@*..=@+..:@@...-@@*...#@*...........
.............%@*...*@@#@%...%@:..#@+.*@#..=@=...@@%@@+...*@%.............
..............-@@#...:%%...#@...+@+...+@+..#@=...@#....#@@:..............
................:#@@+.....+@=..+@%-:.-=@@+..#%......+@@#.................
...................-#@@#-......=+*#+.**+=:......-#@@#-...................
......................:+%@@@#+-:.........:-+#@@@%+:......................
...........................:-+#@@@@@@@@@@@#+-:...........................
.........................................................................
.........................................................................
